1111111111111111111111111111111111
100000000000C0000000000000C0000001
1C01111000000C0000000000000C00C001
100001111100000011000C000000000001
100000000C00000000000000000C000001
111111100000C00P0110001111100000C1
10000C0000000000000000C00000000001
10000C0000000000C00000C0000000C001
1000C001100000C00000000000000E0001
1000000000000000000000000000000001
1000000000000000000000000000000001
1000000000000000000000000000000001
1111111111111111111111111111111111