111111111111111111
1000000C00000000C1
1000C00C000C00C001
1000P0000C00000C01
100E0000C000C00001
111111111111111111