111111111111111111111111111111111111111111111111
1P0000000000000000000000000000000000000000000001
111111101111111011111111111111111111111111111101
100000001000000010000000000000000000100000000001
101111111011111010111111111111111111101111111101
1000000010000010100000000000000000010000000C0001
111110M0101110101111M11111101111111111M111111111
100010001000001000000000001000000000100000000C01
101011111011111011111111101011111111101111111101
100010000010000010000C00010000000001000000000001
111010111110111110111011110111111111111011111101
100010100000100000100010000100000100000100000C01
101110101111101111101110111110111110111011111101
100000100000100000000010000010000010000000000001
111111101111101111111011111011111101111111111101
100000001000001000000010000010000001000000000E01
101111101011101011111011111010111101011111111101
10000010100000100000C0000001000000100000000C0001
100000100000000000000000000000000000000000000001
111111111111111111111111111111111111111111111111
