111111111111111111111111111111111111111111111111
100000000000000000000000000000000000000001111011
1000111111CCM11111100001111111111111111100000011
100M1C000100001C000100001C0001C00010000100101M01
10001000011110100001111010000111001C000111001001
10M0100001000010000100001000010000100001000M10M1
1000111101000C1111M100001111010MM011110100001001
1M000001M1000000000100001000M0M0001000M1C0001M01
11111M010111111111110111101111111110111111111001
10000C0100000000000000000000000000000000000010M1
100111111111111111111011111111111111111111101001
10010000000001P000001000000000C00000000000001M01
100101111101111111101011111011111111110111101001
1001C00000010000000010C0000M1000000001M0000M10M1
1001111111010111111M1M11111110111111101111101001
100000000001C10000001000000010000000010000001M01
1111111111M1010111111011111110111111101011111001
1000M0000001000100000M000M000000M000M0001000M001
1CM000M0M00000010000000M000ME0M000M00001C0M00001
111111111111111111111111111111111111111111111111