111111111111111111111
1P0000000000C00000011
1C01111000000C0000011
100001111100000011011
100000000C00000000011
111111100000C00001111
10000C000000000000011
10000C0000000000C0011
1000C001100000C000011
100000000000000000011
1000000000000E0000011
101000000000000100111
111111111111111111111
